####################
#..................#
#..................#
#####..............#
#..........#.......#
#.......3..#.......#
#..................#
#..................#
#.....####.........#
#......#P..........#
#......#.#.........#
#..................#
#..................#
#..................#
####################

